{
    "levels":
    [
        [
             [9,0,0,0,0,0,0,0,0,0,9],
             [0,0,0,0,0,0,0,0,0,0,0],
             [0,0,0,0,9,9,9,0,0,0,0],
             [8,0,0,0,9,9,9,0,0,0,0],
             [0,0,0,0,0,1,0,0,0,0,0],
             [0,0,0,0,0,0,0,0,0,0,0]
        ],
        
        
        [
             [9,6,1,1,1,1,1,1,1,6,9],
             [8,6,1,2,2,2,2,2,1,6,8],
             [8,6,1,2,9,9,9,2,1,6,8],
             [8,6,1,2,9,9,9,2,1,6,8],
             [1,1,1,1,1,1,1,1,1,1,1],
             [1,1,1,1,1,1,1,1,1,6,1]
        ]    
    ]
}