{
    "levels":
    [
	
	     [
		     []
		 ],

		
	     [
             [8,8,8,8,8,8,8,8,8,8,8],
             [4,4,4,4,4,4,4,4,4,4,4],
             [5,5,5,5,5,5,5,5,5,5,5],
             [7,7,7,7,7,7,7,7,7,7,7],
             [6,6,6,6,6,6,6,6,6,6,6],
             [3,3,3,3,3,3,3,3,3,3,3]
        ],
		
		
        [
             [1,0,0,0,0,0,0,0,0,0,0],
             [1,2,0,0,0,0,0,0,0,0,0],
             [1,2,3,0,0,0,0,0,0,0,0],
             [1,2,3,5,0,0,0,0,0,0,0],
             [1,2,3,5,4,0,0,0,0,0,0],
             [1,2,3,5,4,1,0,0,0,0,0],
             [1,2,3,5,4,1,2,0,0,0,0],
             [1,2,3,5,4,1,2,3,0,0,0],
             [1,2,3,5,4,1,2,3,5,0,0],
             [8,8,8,8,8,8,8,8,8,8,1]
        ],
        
        
        [
             [5,5,5,5,5,5,5,5,5,5,5],
             [0,0,0,0,0,0,0,0,0,0,0],
             [8,8,8,0,8,8,8,0,8,8,8],
             [8,3,8,0,8,3,8,0,8,3,8],
             [8,8,8,0,8,8,8,0,8,8,8],
             [0,0,0,0,0,0,0,0,0,0,0],
             [0,0,8,8,8,0,8,8,8,0,0],
			 [0,0,8,4,8,0,8,4,8,0,0],
             [0,0,8,8,8,0,8,8,8,0,0]
        ],    

        [
             [9,9,9,9,9,9,9,9,9,9,9],
             [0,0,0,0,9,0,0,0,9,1,0],
             [0,0,0,0,9,0,0,0,9,0,0],
             [0,9,3,0,9,0,9,0,9,0,0],
             [0,9,0,1,9,3,9,5,9,0,0],
             [0,9,0,0,9,4,9,0,9,0,0],
             [0,9,2,0,0,0,9,0,0,0,0],
             [0,9,0,0,0,0,9,0,0,0,1],
			 [0,9,9,9,9,9,9,9,9,9,9]
       ],
	   [
             [0,0,0,2,2,9,3,3,0,0,0],
             [0,0,2,2,4,4,4,3,3,0,0],
             [0,2,2,4,4,4,4,4,3,3,0],
             [0,2,2,4,4,4,4,4,3,3,0],
             [0,2,2,4,4,4,4,4,3,3,0],
             [0,8,0,8,0,8,0,8,0,8,0],
             [0,0,0,0,0,8,0,0,0,0,0],
			 [0,0,0,0,0,8,0,0,0,0,0],
             [0,0,0,9,0,9,0,0,0,0,0],
			 [0,0,0,9,9,9,0,0,0,0,0]
        ]   
    ]
}