{
    "levels":
    [
        [
             [9,0,9,5,5,5,8,0,0,6,0],
             [9,9,9,5,0,5,8,0,6,0,6],
             [9,0,9,5,5,5,8,8,6,0,6],
             [0,0,0,0,0,0,0,0,0,0,0],
             [0,0,0,0,0,0,0,0,0,0,0],
             [9,0,0,0,0,0,0,0,0,0,9],
             [9,0,0,0,9,9,9,0,0,0,9],
             [9,0,0,0,9,9,9,0,0,0,9],
             [9,0,0,0,0,3,0,0,0,0,9],
             [9,0,3,3,3,3,3,3,3,0,9],
             [9,0,3,3,3,3,3,3,3,0,9],
             [9,0,3,3,3,3,3,3,3,0,9]
        ],
        
        
        [
             [0,0,0,0,0,0,0,0,0,0,0],
             [0,0,0,0,0,0,0,0,0,0,0],
             [0,0,0,0,0,9,0,0,0,0,0],
             [0,0,0,0,9,9,9,0,0,0,0],
             [0,0,0,9,9,9,9,9,0,0,0],
             [0,0,9,9,9,9,9,9,9,0,0],
             [0,0,0,9,9,9,9,9,0,0,0],
             [1,1,1,1,9,9,9,1,1,1,1],
             [1,1,1,1,0,9,0,1,1,1,1]
        ],    

        [
            [9,6,1,1,1,1,1,1,1,6,9],
            [8,6,1,2,2,2,2,2,1,6,8],
            [8,6,1,2,9,9,9,2,1,6,8],
            [8,6,1,2,9,9,9,2,1,6,8],
            [1,1,1,1,1,1,1,1,1,1,1],
            [1,1,1,1,1,1,1,1,1,6,1]
       ]  
    ]
}